1111
1TC1
1P01
1001
1E01
1111
