111111
1T0001
1C01C1
1PE101
111111
