1111111
10001E1
10PC101
10001T1
1000001
1111111
