1111111
1T0CP11
1000001
10EC001
1111111
