111111111
1TCTC0001
110000C01
1E1000001
100000001
1C000C1P1
111111111
